NO ./texture/space_1.xpm
SO ./texture/space_2.xpm
WE ./texture/space_3.xpm
EA ./texture/space_4.xpm

F 42,42,42
C 42,42,42

        1111111111111111111111111
        1000000000110000000000001
        10110000011100000000S0001
        1001000000000000000000001
111111111011000001110000000000001
100000000011000001110111111111111
11110111111111011100000010001
11110111111111011101010010001
11000000110101011100000010001
11111111111111111111111111111
11111111111111111111111111111
10000000000000000000000000001
10000000000000001101010010001
11000001110100111110111100111
11110111 1110101 101111010001
11111111 1111111 111111111111
